name Very Small Labyrinth of Dooom
win 1
####################
#.G...E.......G....#
#..G...G...........#
#..G....E..G...G...#
#..E....G....E.....#
#..G..E....G.......#
#.......G..E..G....#
#..G..E....G.......#
####################